New Music Friday 01/19/18 LyricsThe Chainsmokers - Sick Boy
J Balvin, Jeon & Anitta - Machika
Cashmere Cat, Major Lazer & Tory Lanez - Miss You
Justin Timberlake - Supplies
Troye Sivan - The Good Side
6ix9ine, Fetty Wap & A Boogie Wit da Hoodie - KEKE
Rudimental - These Days feat. Jess Glynne, Macklemore & Dan Caplen
Fall Out Boy - Church
LANCO - So Long (I Do)
EDEN - take care
Kris Wu, Rich Brian, Trippie Redd, Joji & Baauer - 18
Betty Who - Ignore Me
Russ - Alone
Mat Kearney - Kings & Queens
NF - NO NAME
Carnage & Lil Pump - i SHYNE
Rejjie Snow - Egyptian Luvr feat. Aminé
Caitlyn Smith - Don't Give Up on My Love
Keith Urban - Parallel Line
Dashboard Confessional - Heart Beat Here
St. Beauty - Not Discuss It
Mabel & Not3s - Fine Line
Kevin George - High Like This
Nipsey Hussle - Last Time That I Checc'd feat. YG
Daddy Yankee - Dura
Higher Brothers - Rich Bitch feat. Ski Mask the Slump God
Kassi Ashton - California, Missouri
Mikky Ekko - Not The One
Wes Period - Wutda Hell
Livvia - Catch A Body feat. Quavo
Timeflies - Little Bit
116 - Light Work feat. Andy Mineo, 1K Phew, Tedashii, WHATUPRG, Lecrae, Trip Lee & Cass
Leven Kali - Do U Wrong feat. Syd
Mt. Joy - Jenny Jenkins
Wafia - The Ending feat. FINNEAS
Tyler Johnson - Give Up On Me
Moon Taxi - Let The Record Play
AWOLNATION - Handyman
Dave East - Woke Up feat. Tory Lanez
Kylie Minogue - Dancing
Remy Ma - Melanin Magic (Pretty Brown) feat. Chris Brown
Tinashe - No Drama feat. Offset
Leon Thomas III - Favorite feat. Buddy
Yung Bans - It’s Snowin pt. 2 feat. Wifisfuneral
Devin Dawson - Placebo
First Aid Kit - Distant Star
YFN Lucci - Street Kings feat. Meek Mill
The Spencer Lee Band - The Wolf
Eves Karydas - Further Than The Planes Fly
Wafia - Breathe
Family Force 5 - Fire On The Highway
Moss Kena - Square One
Young Fathers - In My View
George Ezra - Paradise
Kasbo - Aldrig Mer feat. TENDER
Baby Ariel - Perf
Rafferty - White Flower
SG Lewis - Aura feat. J Warner
Kimbra - Human
Bahamas - No Expectations
Tory Ruperto - Changed
Bella Thorne - Burn So Bright
Burna Boy - Heaven's Gate feat. Lily Allen
Porches - Goodbye
Arty - Sunrise feat. April Bender
Justine Skye - Lil' Boy
Lolo Zouaï - Blue
Haley & Michaels - All Out
Stephen Carey - Summer Cool
Editors - Magazine
Yo La Tengo - Shades of Blue
Everything Is Recorded - Bloodshot Red Eyes feat. Infinite & Green Gartside
WhoMadeWho - Goodbye to All I Know
Loop - Give 'n' Take
Fischerspooner - TopBrazilEmbed