March 2022 Singles Release Calendar LyricsAttention: Please DO NOT edit this page on the NEW song page3/1
Alesso - "Dark"
Alex Cameron - "K Hole"
Charli XCX - "Baby"
CHRIST DILLINGER & BRUHMANEGOD - "Who Better Than Me?"
Coach Party - "Weird Me Out"
Ezra Furman - "Point Me Toward the Real"
HAIM - "Lost Track"
KA$HDAMI - "guap!" ft. TyFontaine, Bankrol Hayden & BasedNas
‚Äãpaopao, La Gabi & Villano Antillano - "roce" ft. ARIA VEGA & Cami Da Baby
PISSKISS - "white lighter"
ROBI - "Ant√≥nimos"
Sharon Van Etten - "Used to It"
Soulja Boy - "No Auto-Tune"
3/2
5 Seconds of Summer - "COMPLETE MESS"
Asan & Luck Ra - "Te Fuiste"
Barrie - "Concrete"
Belle and Sebastian - "Unnecessary Drama"
boyband - "meet me @ our spot!"
Carlos Vives & Camilo - "Baloncito Viejo"
DUCKWRTH - "Power Power" ft. Shaun Ross
Emeli Sand√© - "Oxygen"
IAMCLAY & Alessia Cara - "WTSGD"
Jae Skeese - "Against Tha Grain" ft. Conway the Machine & Flee Lord
Lennon Stella - "Thank You"
Mallrat - "Teeth"
Meg Mac - "Is It Worth Being Sad"
MISSIO - "Say Something"
ODESZA - "Better Now" ft. Maro
Oordaya - "Jamil"
Pacman da Gunman & Hit-Boy - "Told Us Not To Do It" ft. Peezy
Pixies - "Human Crime"
Priya Ragu - "Illuminous"
Rolling Blackouts Coastal Fever - "Tidal River"
Rozzi - "fflow"
SHAED - "Come As You Are"
The Weather Station - "To Talk About"
Tourist - "Your Love"
Vancouver Sleep Clinic - "Love You Like I Do"
Yung Bae - "L.O.V.E." ft. EARTHGANG, Jon Batiste & Sherwyn
3/3
A1 x J1 & Tion Wayne - "Night Away (Dance)"
Alex the Astronaut - "Octopus"
Ê±ü§íπÁîü & ÁéãÊô∫Âæ∑ (Anson Kong & Alton Wong) -"REBOUND"
Apel8 - "Russian Friends"
ArrDee - "Come & Go"
Ashe - "Another Man's Jeans"
Bizarrap & Residente - "Residente: Bzrp Music Sessions, Vol. 49"
Blxst & Zacari - "Sometimes"
Confidence Man - "Woman"
Dave - "Starlight"
David Guetta & Afrojack - "Trampoline" ft. Missy Elliott, BIA & Doechii
Digga D - "G Lock" ft. Moneybagg Yo
ECKO, Big Soto & DJ Tao - "Esto Se Va A Descontrolar"
FABRO & FMK - "Madrid"
Feid - "Nieve"
Greeicy - "T√≥xico"
Hayden James & Cassian - "On Your Own" ft. Elderbrook
Jack White - "Hi-De-Ho" ft. Q-Tip
Joey Bada$$ - "Head High"
Kevin Rold√°n - "BYAK"
Khalid - "Last Call"
KHEA, LIT killah & Rusherking - "Pa Co"
KLP - "Busy Dancing"
Kota Banks - "Mutual XO"
Lenny Tav√°rez & Anitta - "Que Vamo' Hacer?"
Lucius - "Heartbursts"
Lyan - "100 Problemas"
Mario Bautista & Piso 21 - "La Tarea"
Mia Rodriguez - "Shut Up"
Nicole Millar - "Feeling Good Feeling Great"
Pamungkas - "Trust Me With This (Mama)"
Pip Millett - "Ride With Me"
Prince Royce & Mar√≠a Becerra - "Te Espero"
Rels B - "100 TRACKS"
Reykon & Be√©le - "11:11"
Robyn - "Buffalo Stance" ft. Mapei
Sebasti√°n Yatra - "√ârase Una Vez (Pero Ya No) [De "EQSB" Soundtrack]"
Shenseea - "Deserve It"
Slimesito - "CERTIFIED STEPPERS"
Slimesito - "FTP"
Suki Waterhouse - "The Devil I Know"
3/4
30 Deep Grimeyy - "Free Bay Bay"
A Boogie wit da Hoodie & B-Lovee - "Hit Different"
Ad√°n Cruz - "A Mover el Cuello"
Alan Walker & Torine - "Hello World"
Ali Gatie - "Crying in the Rain"
Alice Merton - "Same Team"
Alkaline - "Weekend"
Amador - "Pens√°ndote"
Amelia Moore - "moves"
Ana Mena - "Cuando la noche arriba"
Baby Tate - "Slut Him Out Again" ft. Kali
BasedNas - "Ice on Me" ft. KA$HDAMI
BKTHERULA - "Coupe"
BKTHERULA - "Keep da K"
BlackRoy, El Jordan 23 & Vicho El Incorregible - "Las Chipetia"
Brent Morgan - "What Dreams Are Made Of"
Camila Cabello - "Bam Bam" ft. Ed Sheeran
Cannons - "Hurricane"
Carmen DeLeon - "B√©same Bonito"
Cheat Codes - "Payback" ft. Icona Pop
CHRIST DILLINGER - "A SPIDER GANG SEA SHANTY"
Cochise - "Do It Again"
Cold Hart - "FIRE EYES üìùüåñ"
Cole Swindell - "Down to the Bar"
Crecer Germ√°n - "Miedo"
De La Ghetto - "Loco Por Perrearte"
Ella Henderson - "Everything I Didn't Say"
Farina - "Flow Calle"
Gavin James - "Jealous"
Gigolo Y La Exce & Eladio Carri√≥n - "Nuevo"
Gino2x - "Kicc Bacc" ft. NLE Choppa
Greta Isaac - "how are you not freaking out?"
Griff & Sigrid - "Head on Fire (Remix)" ft. M√ò & King Princess
Hotboii - "Lately"
Hot Chelle Rae - "Stupid Song"
Hylan Starr & Lil Baby - "Don‚Äôt make me beg"
Isabela Merced - "AGON√çA" ft. Kayfex
J.I the Prince of N.Y - "I Ain‚Äôt Gon Lie"
Jade LeMac - "Same Place"
Jason Aldean - "My Weakness"
Jax Jones - "Where Did You Go? (Jax Jones Midnight Snacks Remix)" ft. MNEK
JGreen - "Millions"
Jose Yellow - "D√©jate Ver"
Jossef & Totoy El Fr√≠o - "Algoritmo"
Kane Brown - "Leave You Alone"
keshi - "GET IT"
Kira Brown - "Sabor a Mezcal" ft. AMEX
Lalo Ebratt & Haraca Kiko - "Tos"
Lasso - "DIOS"
Leah Kate - "Dear Denny"
Lil PJ - "Long Days"
Luke Sital-Singh - "California"
Lyanno - "G&P3"
Machine Gun Kelly & Lil Wayne - "ay!"
MAR MEJ√çA - "Money"
Marc Anthony - "Nada de Nada"
Matilda - "Everything I Want"
Mitch James - "History"
Morgan Evans - "Country Outta My Girl (Remix)" ft Rivers Cuomo
Morray - "Still Here" ft. Cordae
Nawi - "LA POPI"
NIA, Gente De Zona & JC el Diamante - "TULUM"
Nigo & Pusha T - "Hear Me Clearly"
Omah Lay & Justin Bieber - "Attention"
Party Favor - "I See You" ft. Marc E. Bassy
Pedro Cap√≥ & Farruko - "Gracias (Remix)"
Pitizion - "Perro Es Perro"
Placebo - "Happy Birthday in the Sky"
Popcaan - "Skeleton Cartier"
Powfu - "sleeping on the floor"
Princesa Alba - "‚Äã‚Äãdiario de vida"
Rapeton Approved & Catalyna - "Catalyna la O"
Red Hot Chili Peppers - "Poster Child"
Revol, Dalex & Arc√°ngel - "Whattsup" ft. Bryant Myers
Rezz & Subtronics - "Puzzle Box"
R√≠o Roma & Carin Le√≥n - "T√∫ Me Gustas"
ROSIE - "Next Life"
Selfmxdebless - "ENVY"
Sigala - "Melody (Extended)"
Sof√≠a Vald√©s - "I Hate The Beatles"
Sofi Tukker & Mahmut Orhan - "Forgive Me"
Smooky MarGielaa - "Bronx Baby"
Squash - "Ready"
Stine Bramsen - "Mother Earth"
Sy Ari da Kid - "Press 0" ft. Benny The Butcher
Tee Grizzley - "Beat The Streets"
The Regrettes - "That's What Makes Me Love You"
Thomas Rhett - "Death Row" ft. Tyler Hubbard & Russell Dickerson
Tiana Major9 - "Try Peace..."
Tom The Mail Man - "Over"
Wallows - "At the End of the Day"
Wild Youth - "Seventeen"
‚Äãwolfacejoeyy - "peace of mind"
YNW Melly, Trippie Redd & YNW BSlime - "The Mob" ft. YNW Bortlen
Yungeen Ace - "Life of Sin"
3/5
Jay Critch - "Click"
Since99 - "Trendsetter"
Soulja Boy - "Swag Walk"
3/6
Spider Gang - "GET RICH OR DIE CRYIN"
3/7
BRELAND - "Praise the Lord" ft. Thomas Rhett
chloe moriondo - "sammy"
Florence + The Machine - "Heaven is Here"
Jenny Hval - "Freedom"
Kae Tempest - "No Prizes" ft. Lianne La Havas
Lil Darkie & BVDLVD - "GAS!"
Marcelo Mellino - "T√∫ Me Dejaste"
Moderatto & Danna Paola - "S√≥lo Qu√©date en Silencio"
Omy De Oro - "La Nueva Pandemia"
Rowdy Rebel - "Ah Haa ‚ÄúFreestyle‚Äù"
Sunflower Bean - "Roll the Dice"
Superorganism - "Teenager" ft. CHAI & Pi Ja Ma
Vaundy - "ÊÅãÈ¢®ÈÇ™„Å´„ÅÆ„Åõ„Å¶(Koikaze ni nosete)"
White $osa - "Off the Rip" ft. NLE Choppa

3/8
Aldous Harding - "Fever"
Bill Wurtz - "‚Äã‚Äã‚Äã‚Äãfly around"
CHRIST DILLINGER - "Im The Man" ft. Acid Souljah
DEKKO - "Cocoloco"
Fanny Lu - "Vali√≥ La Pena"
Jimmie Allen - "Down Home"
Kali - "Standards"
Leslie Grace - "Un Buen D√≠a"
Luke Steele - "Armageddon Slice"
Maddy Jane - "It's a Lot"
Mandy Moore - "In Real Life"
Phoebe Green - "Make It Easy"
Rachel Chinouriri - "All I Ever Asked"
Son Lux - "This is a Life" ft. David Byrne & Mitski
Soulja Boy - "Euphoria"
Wendigo - "Wendigo"
3/9
Aya Nakamura - "D√©gaine" ft. Damso
CXRPSE - "Therapy"
Eli Derby & 6LACK - "Lately"
Emmit Fenn - "Human"
Enchanting - "Take It Back"
Everything Everything - "Teletype"
Father John Misty - "Goodbye Mr. Blue"
Jay Critch & Mally Bandz - "Drank In My Cup"
Kita Alexander - "Run"
Marian Hill - "SPINNIN" ft. Kemba & Steve Davit
Milky Chance - "Synchronize"
Rex Orange County - "OPEN A WINDOW" ft. Tyler, The Creator
Sigrid - "It Gets Dark"
Snow Tha Product & Haraca Kiko - "Nieve"
Tomberlin - "tap"
WARA - "NEW-TEZTAMENT"
3/10
Aitch & Ashanti - "Baby"
Ë®±Âª∑Èèó (Alfred Hui) - "Ê≤íÊúâ‰∫∫ÂèØ‰ª•ÁÇ∫‰Ω†ÁöÑÂπ∏Á¶èË≤†Ë≤¨ (Nobody But Yourself)"
Alison Wonderland - "New Day"
Amanda Tenfjord - "Die Together"
Chanel Loren - "Playlist"
Darren Hayes - "Do You Remember?"
Ed√©n Mu√±oz - "Chalino"
Florence + The Machine - "My Love"
FMK & Duki - "Tu Nombre"
JD Pantoja - "Ya volv√≠"
Jhay Cortez - "Sensual Beb√©"
Jon Z & Juhn - "Ansioso"
Joonti - "Cobarde"
Justin Quiles & Eladio Carri√≥n - "GUCCI FENDI"
Kaleb Di Masi, ECKO & Cazzu - "Matatan (Remix)" ft. Alan Gomez, Brray & DJ TAO
Key Glock - "Pain Killers"
Kiko El Crazy & Arc√°ngel - "Te Doblaste"
Lexi Jayde - "hate to be you"
Marshmello - "Before U"
merci, mercy - "Sick To My Stomach"
Michael Bubl√© - "Higher"
Miranda Lambert - "Strange"
Monsieur Perin√© - "Nada"
OBLVYN & RIELL - "With You"
Oh Wonder - "Magnificent"
Oliver Sim - "Romance With a Memory"
Ozuna - "G Wagon"
Èô≥Ëïæ (Panther Chan) - "‰∏ñÁïåËàá‰Ω†ÁÑ°Èóú (Embrace Yourself) (Acoustic Version)"
Sean Paul - "How We Do It" ft. Pia Mia
Spider Gang - "walk in with some racks"
The Black Keys - "Wild Child"
Ventino - "Stop"
3/11
$nxw Bxnk$ & YNW BSlime - "Fair Enough"
Alanis Morissette - "Olive Branch"‚Äã
Albyy - "Bipolar"
Alexandra Stan - "Bad at Hating You"
Amaia - "Bienvenidos Al Show"
B-Lovee - "Boom Boom" ft. A Boogie wit da Hoodie
Banda MS de Sergio Liz√°rraga - "Amigos ¬øDe Qui√©n?"
Brenji - "FEEL"
BRS Kash - "RBS (Rich Bish Shit)"
Bryce Vine - "American Dream"
Calibre 50 - "M√≠ranos Ahora"
Claire Rosinkranz & Aidan Bissett - "stuck on us"
Cody Simpson - "Let Go"
COIN - "Brad Pitt"
Coldplay & Selena Gomez - "Let Somebody Go (Kygo Remix)"
‚ÄãcupcakKe & Tay Money - "PTPOM (Shemix)" ft. ShantiiP
Desiigner - "Move How We Move"
Draft Day - "How Far Will I Go" ft. Lil Yachty
Ekali & RemK - "Remember Me"
Eli Young Band - "Break Up In A Bar"
Fenix Flexin - "Dead Homies"
Fireboy DML, Rexx Life Raj & Wale - "Beauty & The Madness"
Fredo Bang - "Federal Raid"
Futuristic, Berner & Dizzy Wright - "I Guess I'll Smoke Again" ft. Durand the Rapper & Boboy Watson
Gaby Moreno - "Nobody's Wrong"
Imagine Dragons - "Bones"
J Alvarez - "Har√©, Har√©"
Jay Worthy & Larry June - "Leave It Up To Me"
Èô≥Âì≤Âª¨ (Jerald Chan) - "Happy Me"
JW ÁéãÁÅùÂÖí - "Á¥çÊñØÂç°Á∑ö (Nazca Line)"
Karol Sevilla - "Dime Dime"
KILLKODY, Lil Tracy & Bighead - "Backend"
Kx5 - "Escape" ft. Hayla
KYLE - "Carefree"
KYSLINGO - "‚Äãthat feeling"
lael - "garbage bag"
Latto - "Wheelie" ft. 21 Savage
Lil Eazzyy - "Forever Been Steppin'"
Luis Fonsi - "Dolce"
Maren Morris - "Nervous"
Megan Thee Stallion - "Sweetest Pie" ft. Dua Lipa
Mocedades & Gloria Trevi - "Amor de Hombre"
Mothica - "SENSITIVE"
Ms Banks & Tion Wayne - "Typa Way" ft. Eight9FLY
NLE Choppa - "The Gender Reveal Song"
Omar Apollo - "Killing Me"
Play-N-Skillz & Guaynaa - "El Doggy (Perreo)" ft. Ovi & Randy
Quin NFN - "Walk The Line"
Rapeton Approved & Villano Antillano - "Veo Veo"
Rema - "FYN" ft. Aj Tracey
RHODES - "No Words"
Ron Suno - "Any Second" ft. Rah Swish
Ruel - "LET THE GRASS GROW"‚Äã
Selfmxdebless - "TOO MUCH KILLS"
st. Pedro - "Te Compart√≠a"
Static & Ben El & Snoop Dogg - "Ziki Ziki" ft. Lil Baby
Stunna 4 Vegas - "The One"
Suigeneris & yvngxchris - "‚Äãskinny jeans & rick owens"
Takeoff & Rich the Kid - "Crypto"
The Chainsmokers - "iPad"
The Script - "Superheroes (Acoustic)"
Tory Lanez - "CAP"
Tove Styrke - "Hardcore"
Whethan - "Mental" ft. Slump6s & glaive
Wicca Phase Springs Eternal - "Tracer"
Yella Beezy - "Who Do"
YUNGBLUD - "The Funeral"
3/12
‚Äãyvngxchris - "‚Äã‚Äã‚Äã‚Äãrip paul walker" ft. BabySantana

3/13
Corina Smith - "Antisocial"
3/14
BVDLVD - "SCORN"
Charli XCX - "Every Rule"
Cold Hart - "‚Äã‚ÄãiIM SPRUNG"
Lil Gotit - "Freestyle"
Lil Zay Osama - "Fuck My Cousin"
Yozuel & Yan Block - "Malas Vibras"
3/15
Bleachdiego - "RIP Scott Hall Samples"
CHRIST DILLINGER - "We Will Fly" ft. Lil Darkie
Grupo Firme, Beto Sierra & MC Davo - "As√≠ Es La Vida"
Icewear Vezzo - "First 48"
Lil Darkie & EDDISON - "Scammin‚Äô"
MUNA - "Anything But Me
√ëejo - "Esta Vida Es Presta"
ROBI - "Desconocidos"
Soulja Boy - "Call Of Duty"
Soulja Boy - "Just Did It"
Soulja Boy - "Kizzy"
Soulja Boy - "Rich Again"
Wendigo - "Mad Science Lab"
Zheit - "Mis Errores"
3/16
Ca7riel & Paco Amoroso - "PAGA DIOS"
El Alfa & El Mayor Cl√°sico - "GALAPIN"
ÊùéÂπ∏ÂÄ™ (Gin Lee) - "ÂâõÂ•Ω (Just Right)"
Jaycoma - "Imag√≠nate"
Joyce Wrice - "Iced Tea" ft. KAYTRANADA
Machine Gun Kelly & Bring Me The Horizon - "maybe"
È©¨ÊÄùÂîØ (Masiwei) - "SNTS"
Natanael Cano & Grupo Codiciado - "De A De Veras"
Nova Twins - "Cleopatra"
Pacman da Gunman & Hit-Boy - "Not Your Average"
PLUM-BLOSSOM - "USED TO LIKE YOU"
Áü≥Â±±Ë°ó (Rock Hill Street) - "ÂÖàÁü• (Destiny)"
ROSAL√çA - "HENTAI"
Sauceda SM & Lefty Sm - "Prendidos"
3/17
44 Kid & Mesita - "Pary Fumeteo"
Akim - "Follower"
Alejo, Feid & Robi - "Pantysito"
Amenazzy & Eladio Carri√≥n - "Ausente"
Arni Rom - "Bajo Cero"
BRICK! - "‚Äã‚Äãthursday!" ft. Guapdad 4000 & KYLE
Cami - "EL PEOR"
Cazzu & DJ Tao - "Cazzu | DJ TAO Turreo Sessions #9"
Charli XCX - "Used to Know Me"
Dee Watkins - "Time‚Äôs Up"
Digga D - "Life of a Real G (Freestyle)"
Dvicio - "ARTE"
Dylan Fuentes & Ingratax - "Sin Ropa"
FMK - "Gatas"
Freshie - "‚ÄãmidnightCLUB!" ft. Trippie Redd
Ha*Ash - "Lo Que un Hombre Deber√≠a Saber"
Jovaan - "Mito" ft. Amarion
Kaleb Di Masi, C.R.O & Omar Varela - "Cheto Mal"
KennyHoopla - "DIRTY WHITE VANS//"
KEVVO - "Influencer"
Key Glock - "Play For Keeps"
La Ross Maria & Leon Leiden - "Mereces Menos"
Luana - "Ser√° Mi Culpa?"
M Huncho - "Lean" ft. Giggs
Miky Woodz, Jay Wheeler & Nio Garc√≠a - "Nadie"
Mili - "Skin-Deep Comedy"
Residente - "This is Not America" ft. Ibeyi
Tiago PZK - "Hablando De Love"
Tones and I - "Eyes Don't Lie"
Tony K - "Never Been Better"
Y√≠√°n - "Una Noche"
3/18
88GLAM - "Ziploc"
Alkilados - "C√≥mo Voy a Olvidarte"
ArrDee - "Early Hours"
Baby Hot - "ScatPacc" ft. NLE Choppa
Bad Gyal - "Flow 2000 (Remix)" ft. Beny Jr
Bailey Bryan - "MF" ft. 24kGoldn
BigWalkDog - "Real as It Gets"
Bleachdiego - "Clientele"
Blessd, Myke Towers & Ovy on the Drums - "Tendencia Global"
BONES & grayera - "TheOne"
BRYN - "Clouds"
‚Äãb√ºlow - "Playing Me Back"
Capella Grey & Nija - "Confujawn"
Carlitos Rossy - "Crec√≠a"
Chris King - "DO WITH YOU" ft. Trippie Redd
Chucky73 - "Hmm"
Coi Leray & Nicki Minaj - "Blick Blick"
Cold Hart - "snowwhite + whispers"
Coldplay & Selena Gomez - "Let Somebody Go (Piano Version)"
COLLAR - "Never-never Land"
Cosculluela - "Inocente"
DJ Nelson, Wisin & Yandel & Baby Rasta & Gringo - "Te Veo Bailar" ft. Brray & Alejandro Armes
Doechii - "Persuasive"
D.OZi - "Pa' Los M√≠os"
Elaine - "Shine"
Fivio Foreign - "Magic City" ft. Quavo
GALE - "Inmadura"
gavn! - "lift you up (someone else)"
GRIP - "Dirty Work"
INNA - "UP (Kaluma Remix)"
J.Grand - "Si T√∫ Supieras"
Jada Kingdom - "Dickmatized"
Jeeiph & Noreh - "2.0"
Joel Corry, David Guetta & Bryson Tiller - "What Would You Do?"
Jos√© Madero - "Nadie M√°s Vendr√°"
Juice WRLD - "Sometimes"
Julieta Venegas - "Mismo Amor"
Kayzo & Siiickbrain - "Moonlight"
King Princess - "For My Friends"
Laya Kalima - Provoc√°ndome
Lil PJ - "Speeding Fast" ft. CEO Trayle
Lil Poppa - "The Wire" ft. Jdot Breezy
Lul Bob - "Trapped Out"
Mabel, Jax Jones & Galantis - "Good Luck"
Mahalia - "Whatever Simon Says"
Maia Reficco - "R√°pido y Furioso"
Mandisa - "Out Of The Dark (Petey Martin Remix)"
Never Sleeps - "Stay With You" ft. Manse, DubVision & Afrojack
NGHTMRE & SLANDER - "Fall Into Me" ft. Dylan Matthew
Nigo & Lil Uzi Vert - ‚ÄúHeavy‚Äù
Normani - "Fair"
Pollari - "Complicated!"
Princess Nokia - "No Effort"
Rapeton Approved & Jeremy G - "Desnuda"
Robinson & Jason Derulo - "Ayo Girl (Fayahh Beat)" ft. Rema
ROSAL√çA - "CANDY"
Sada Baby - "Bop Stick"
Èô≥ÁèäÂ¶Æ (Sandee Chan) - "ÊçÜÁºö (Bondage)"
Sasha Alex Sloan - "WTF"
Selfmxdebless - "HIT THE FLOOR"
Slump6s - "Chrome Hearts Jacket"
SosMula - "YAKUZA 2000"
‚ÄãSSGKobe - "ESCAPE YOUR LOVE (Remix)" ft. Trippie Redd
Steele 11 - "CHAINSAW MAN!"
Steve Aoki, Marnik & Leony - "Stop the World"
Syd & Lucky Daye - "CYBAH"
Tom Grennan - "Remind Me"
Trav - "Toxic" ft. Rowdy Rebel
T-Shyne - "TOP 5"
Unlike Pluto - "Cold Weather"
Villano Antillano - "Vocales"
‚Äãwolfacejoeyy - "‚ÄãRUN! (2067)"
‚Äãyvngxchris - "hoes vs girls :/"
Yandar & Yostin - "Si Acaso"
Zerimar - "Recuerdo"
3/19
CHRIST DILLINGER - "Mercedes Benz S Class"
3/20
BFB Da Packman - "Cant Blame Ye"
Desiigner - "HILLS ALIVE"
Onlybino! - "R.I.P Virgil" ft. DC The Don

3/21
Arlene MC - "Lakia"
BANKS - "I Still Love You"
Denzel Curry - "Troubles" ft. T-Pain
Digga D - "On the Radar (Freestyle)"
Fontaines D.C. - "Skinty Fia"
Lil Darkie - "SHOW SONG"
‚Äãyvngxchris - "‚Äãsentimental" ft. Onlybino!

3/22
42 Dugg & EST Gee - "Free The Shiners"
Asian Doll - "Baby" ft. Sheemy
Bankroll Freddie - "Broke ASF"
Bhavi & Santa Fe Klan - "Dios y La Muerte"
Ca7riel & Paco Amoroso - "EN EL AFTER"
Disclosure & RAYE - "Waterfall"
‚Äãfl.vco - "‚Äã‚Äãwhat do I know"
Girlpool - "Nothing Gives Me Pleasure"
Hatchie - "Lights On"
KA$HDAMI - "‚Äãposed2be"
Kilo Kish & Miguel - "DEATH FANTASY"
Koffee - "Shine"
‚Äãkoi - "toast to me"
KOLOR - "Êµ∑Â∫ïÈößÈÅì (Harbour Crossing)"
Mykki Blanco - "Family Ties" ft. Michael Stipe
Sig.Carlito - "it rains"
Soulja Boy - "Catch Me a Body"
Unfoonk - "DEA"
Wendigo - "Do Not Interfere With My High"
3/23
beabadoobee - "Talk"
Deante‚Äô Hitchcock - "Alone"
Evaluna Montaner - "Refugio"
flor - "Big Shot"
flor - "Skate"
Flor Vigna - "Una en un Mill√≥n"
Kenia OS - "Se Fue la Luz"
Luke Steele - "Pool Of Love"
Lykke Li - "No Hotel"
Mario La Mo√±a - "Peine Banana" ft. Ecko
MISSIO - "Demons"
MISSIO - "We Are Who We Are"
ODESZA - "Love Letter" ft. The Knocks
Omar Apollo - "Tamagotchi"
OSTON - "HARD TO LOVE"
Paulo Londra - "Plan A"
Quando Rondo - "10.27"
Raffaella - "BLONDE"
R√∂yksopp - "Breathe" ft. Astrid S
Sebasti√°n Yatra & John Legend - "Tacones Rojos"
Sheff G - "Break From It"
Sig.Carlito & Zelly Ocho - "‚Äãdouble dare lolz"
Soccer Mommy - "Shotgun"
Soulja Boy - "Exotic"
Soulja Boy - "Freeze Time" ft. Desiigner
Soulja Boy - "Melody"
Sycco - "Superstar"
The Vaccines - "Disaster Girl"
Tyson Yoshi - "i don't smoke & i don't drink"
Will Linley - "wrong time"
Wolfe - "ÊúâÂï≤Âò¢ÂîîË¨õÂæó (Some Things Can‚Äôt Be Said)"
Zola Jesus - "Lost"
3/24
Ally Brooke - "Tequila"
Blossoms - "The Sulking Poet"
BiC Fizzle - "Turnt Shit"
Bree Runway - "Somebody Like You"
Callejero Fino, L-Gante & ECKO - "Pa Tra Rkt (Remix)" ft. Kaleb Di Masi, Fili Wey, Homer El Mero Mero, John C & Papichamp
Cauty - "Muchisito y Chao"
Chance the Rapper - "Child of God"
Christina Perri - "evergone"
Claudia Valentina - "Extra Agenda"
Duwap Kaine - "Shopping Spree"
Emilia - "CUATRO VEINTE"
FLO - "Cardboard Box"
J Balvin & Ed Sheeran - "Forever My Love"
J Balvin & Ed Sheeran - "Sigue"
James Bay - "Give Me The Reason"
ÈÑ≠Ê¨£ÂÆú (Joyce Cheng) - "Ë±ê‰π≥ËÇ•ËáÄ (Big Boobs Bubble Butt)"
Kendy Suen - "Êó•ÊúàÁÑ°Â∏∏ (Impermanence)"
Let's Eat Grandma - "Levitation"
Luis Figueroa - "Todav√≠a Te Espero"
Maluma - "Mojando Asientos" ft. Feid
Meg Myers - "HTIS" ft. Luna Shadows & Carmen Vandenberg
MrCheezl - "CHEEZL SAMPLER MAR 2022 ****"
mxmtoon - "sad disco"
Oni - "War Ender" ft. City Morgue
Piso 21 & √ëejo - "Salvavidas"
Red Hot Chili Peppers - "Not the One"
Sabrina Claudio - "Better Version"
Seven Kayne - "Eso Que Ten√©s"
The Amazons - "Bloodrush"
Unknown T - "Often"
XYL√ò - "sweetheart"
3/25
24kGoldn & Travis Barker - "In My Head"
27CLUB & Jez Dior - "2 LATE"
350Heem - "Back 2 the Block"
Albino - "NMNM"
Alex Lahey - "This Kiss"
Anonimus & VLA Music Entertainment - "Tarde"
Arizona Zervas - "MY TIME"
BigKayBeezy - "Area 51 (PackMix)" ft. BFB Da Packman
Brevin Kim - "COME TO GOD"
Bruello & Princy - "Waterfall" ft. Alexino & Lil Scottish
BRUHMANEGOD - "Plywood"
Catie Turner - "Nothing"
Celeste - "To Love a Man"
Cheat Codes & Stondon Massey - "Afraid of Love"
Coco Jones - "Caliber"
Doodie Lo - "Melrose" ft. Icewear Vezzo
FINNEAS - "Naked"
Fredo Bang - "No Love" ft. Sleepy Hallow
G Perico - "Another League"
Gabbie Hanna - "I Sold My Soul"
Gabi - "Si Nos Besamos"
Gabi DeMartino - "Broken Morning"
HD4President - "Celebration"
Immasoul - "Florecer"
Jack Savoretti - "Love of Your Life"
Jamie Miller - "Last Call"
Javiielo - "D√≠as Grises"
Jazmin Bean - "Puppy Pound"
JESSIA - "Next Time"
Jnr Choi & Gunna - "TO THE MOON (Remix)"
Jowell & Randy - "20 Aniversario"
Juanfran, Moncho Chavea & Antonio Hernandez - "No Lo Niegues"
Kid Cudi - "Stars in the Sky"
lael - "bully"
Lauri Garcia - "Contigo"
Lefty Sm & Carin Le√≥n - "Ahora Estoy Mejor"
Leroy Sanchez - "Bla, Bla, Bla"
Lil Skies - "Play This at My Funeral" ft. Landon Cube
Lil Tracy - "Heavenly"
Louis The Child & Aluna - "Cry"
Lous and the Yakuza - "Kis√©"
ÁõßÂÜ†Âª∑ & È∫•ÊµöÈæç (Lowell Lo & Juno Mak) - "ÊóãÂæãÔºéÊïÖ‰∫ã (A Tune, A Tale)"
Lyan - "La Culpa"
Mar√≠a Le√≥n - "Quebradita" ft. Pliego Villareal
Martin Garrix & Zedd - "Follow"
MUST DIE! - "ANGELWARE"
Nicki Minaj - "We Go Up" ft. Fivio Foreign
Nina & Ingratax - "K Pasar√°? (Live Session)"
NOEL - "Rat Race"
Pollari - "Company" ft. LIL DUSTY G
Ricky Montogmery - "Settle Down"
Rob49 - "Vulture Island (V2)" ft. Lil Baby
ROLE MODEL - "neverletyougo"
RY X - "Your Love"
Saga WhiteBlack, Nacho & Brray - "Qu√©date"
Samantha S√°nchez - "Bad Kiss"
Selfmxdebless - "LIFES DEAD"
Sharlene - "A Veces A Besos"
Sheryl Crow - "Forever"
St. Lucia - "Another Lifetime"
Stunna 4 Vegas - "Pay Me to Speak"
Summer Walker, SZA & Cardi B - "No Love (Extended)"
Surf - "PTSD"
Surf Mesa & Nitti Gritti - "Marching Band"
Tai Verdes - "3 outfits"
Tate McRae - "chaotic"
Tory Lanez - "Taken Care"
TURNABOUT - "Bolos"
Unlike Pluto - "Silly How I Feel"
Warren Hue & yvngxchris - "W"
Willy William, will.i.am & Lali - "Solo"
Yubeili - "Otra Noche" ft. Maikel Delacalle & Falke 912
Yungeen Ace & Kodak Black - "B.A.M."
Yung Lean - "Trip"
Zaramay, El High & Polakan - "Pla Pla"
3/27
KirbLaGoop - "Debating Suicide (Ima Fall)"
3/28
Acid Souljah - "Pill Pronky" ft. SecretWebCamGirl
CXRPSE - "CHARLIE SHEEN" ft. JAMES GORCZYCA
ÈªÉÊòéÂæ∑ (Dark Wong) - "ÁïôÁè≠ÂêåÂ≠∏ (The Repeater)"
Enrique Iglesias - "Espacio en Tu Coraz√≥n"
Everything Everything - "I Want A Love Like This"
È¶ÆÂÖÅË¨ô (Jay Fung) - "Â†±Âæ©ÂºèÊµ™Êº´ (Sweeetly)" ft. moon tang
Latto & Mariah Carey - "Big Energy (Remix)" ft. DJ Khaled
Lil Darkie & BVDLVD - "10 FOOT TALL"
Onlybino! - "‚Äãfortune cookie remix"
Torch BeenUp - "Broken Words"
Vince Staples - "ROSE STREET"
3/29
Bill Wurtz - "9 8 7"
Catalyna - "Astucia"
John C - "Rompediscoteka"
Onlybino! - "urgent"
ROBI & Nohemy - "Av√≠same"
3/30
$NOT - "9"
42 Dugg & EST Gee - "Everybody Shooters Too"
AK4:20, Pailita & Cris Mj - "Me Arrepent√≠"
Alejandro Santamaria & Sael - "100"
C.R.O & Dani Ribba - "Normal"
Conkarah & Pedro Cap√≥ - "Millonario"
Faouzia - "RIP, Love"
Flume - "Sirens" ft. Caroline Polachek
Hozwal & Juliito - "Rolex"
Ibeyi & Jorja Smith - "Lavender & Red Roses"
IHATEYOUSHEED & Miles Chancellor - "Sunsets"
Kehlani - "up at night" ft. Justin Bieber
Lauren Sanderson - "Tongue Tied"
Lil Gotit - "Take Care" ft. Millie Go Lightly & Toosii
ÂºµÈÄ≤Áøπ (Manson Cheung) - "QUEST?ONS"
M√≥nica Naranjo - "Ey!" ft. Bunbury
ËóçÂ•ïÈÇ¶ (Pong Nan) - "ÈÜ´ÁîüÊàëÁÑ°ÁóÖ (Doctor I Ain‚Äôt Sick)" ft. Matt Force
Pouya & Fat Nick - "Seven Figure Habits"
‚Äãredveil & Sam Truth - "‚Äãbetter"
Summrs - "‚Äãim rich"
Taichu - "GABBANA"
THE BLSSM - "NOT TODAY"
Tom Odell - "Best Day of My Life"
Zaucy - "LA CANCI√ìN"
3/31
10Percent - "Dior Funeral 2.0"
Aitana - "En El Coche"
Alba Reche - "‚Äãno cambies tu andar"
Anuel AA & Yailin la Mas Viral - "Si Tu Me Busca"
Brytiago & Bryant Myers - "El Congreso"
ChocQuibTown - "Bitcoin"
Dean Lewis - "Hurtless"
Duki, De La Ghetto & Quevedo - "Si Quieren Frontear"
Ella Mai - "Leave You Alone"
JELEEL! - "Rain On You!"
KEITYN - "Anoche"
KEVVO, Farruko & Wisin - "SMP (Sol, Mar y Playa)"
Lucki - "New Drank"
Lyanno - "Guay"
Madonna & Sickick - "Frozen (070 Shake Remix)" ft. 070 Shake
Mak Sauce - "SPEEDRACER" ft. MkGoinUp
Nina - "TERMINAMOS"
Polim√° WestCoast, Young Cister & Cris Mj - "SEXTIME"
ROA - "Bellakeame"
S+C+A+R+R - "Running Away"
Shawn Mendes - "When You're Gone"
V√≠ctor Manuelle - "Vamo' a Ver Si el Gas Pela" ft. Miky Woodz & Marvin Santiago
Winona Oak - "Baby Blue"
Yomiel & Amarion - "Bella"1Embed